000000001010000000000000000000
000000001100000000000000000000
000000001000000000000000000000
000000001000000000000000000000
000000022222000000000000000000
000000000000000000000000000000
220000000000000002200000022000
112222222200000000000002211200
111111111100000000000001111100
111111111100000000000000110000
111111111100000000000000100000
111111111100000000000000100000
111111111111111111100000000000